24 24
1 1 1 1 1 1 1 0 0 0 6 0 0 0 0 0 0 0 1 1 1 1 1 1
1 1 1 1 1 0 0 0 0 6 6 0 0 0 0 0 0 0 1 1 1 1 1 1
1 1 0 0 0 0 0 0 0 6 6 0 0 0 6 0 0 0 0 0 0 1 1 1
1 1 0 0 0 0 0 0 0 0 6 0 0 6 6 0 0 0 0 0 0 0 1 1
1 1 0 0 0 0 0 0 0 0 0 0 0 6 0 0 0 0 0 0 0 0 0 0
1 0 0 0 0 0 0 0 0 0 0 1 1 6 0 0 0 0 0 0 0 0 0 0
0 0 0 0 0 0 0 1 1 1 0 1 1 6 0 0 0 0 0 0 0 0 0 0
0 0 0 0 0 0 0 1 1 1 0 1 1 6 0 0 0 0 0 0 0 0 0 0
0 0 0 0 0 0 0 0 0 0 0 0 0 0 0 0 1 1 0 0 0 0 0 0
1 1 0 0 0 0 0 0 0 1 1 1 1 1 1 0 1 1 0 0 0 0 0 0
0 1 1 0 0 0 0 0 0 1 1 1 1 1 1 0 1 1 0 6 0 0 0 0
0 0 1 0 0 0 0 0 0 1 1 1 1 1 1 6 0 0 0 6 6 0 0 0
0 0 0 0 0 0 0 0 0 0 0 0 1 1 1 6 6 0 0 6 6 0 0 0
1 1 0 0 0 0 0 0 0 0 0 0 1 1 1 6 6 6 0 6 6 0 0 0
1 1 1 0 0 0 0 0 0 0 0 0 0 0 0 6 6 6 0 0 6 0 0 0
1 1 1 0 0 0 0 0 0 0 0 0 0 0 0 6 6 6 0 0 0 0 0 0
1 1 1 0 0 0 0 0 0 0 0 0 0 0 0 0 6 6 0 0 0 0 0 0
1 1 1 0 0 0 0 0 0 0 0 0 0 0 0 0 0 0 0 0 0 0 0 0
1 1 0 0 0 0 0 0 0 0 0 0 0 0 0 0 0 0 0 0 0 0 0 0
0 0 0 0 0 0 0 0 0 0 0 0 0 0 0 0 0 0 0 0 0 0 0 0
0 0 0 0 0 0 0 0 0 0 0 0 0 0 0 0 0 0 0 0 0 0 0 0
1 1 1 0 0 0 0 0 0 0 0 0 0 0 0 0 0 0 0 0 0 0 0 1
1 1 1 1 1 0 0 0 0 0 0 0 0 0 0 0 0 0 0 0 0 1 1 1
1 1 1 1 1 0 0 0 0 0 0 0 0 0 0 0 0 0 0 0 1 1 1 1
1
1 1 1 1 1 1 1 0 0 0 6 0 0 0 0 0 0 0 1 1 1 1 1 1
1 1 1 1 1 0 0 0 0 6 6 0 0 0 0 0 0 0 1 1 1 1 1 1
1 1 0 0 0 0 0 0 0 6 6 0 0 0 6 0 0 0 0 0 0 1 1 1
1 1 0 0 0 0 0 0 0 0 6 0 0 6 6 0 0 0 0 0 0 0 1 1
1 1 0 0 0 0 0 0 0 0 0 9 9 6 0 0 0 0 0 0 0 0 0 0
1 0 0 0 0 0 0 0 0 0 0 9 9 6 0 0 0 0 0 0 0 0 0 0
0 0 0 0 0 0 0 1 1 1 0 1 1 6 0 0 0 0 0 0 0 0 0 0
0 0 0 0 0 0 0 1 1 1 0 0 0 0 0 0 9 9 0 0 0 0 0 0
0 0 0 0 0 0 0 0 0 9 9 9 9 9 9 0 9 9 0 0 0 0 0 0
1 1 0 0 0 0 0 0 0 9 9 9 9 9 9 0 1 1 0 0 0 0 0 0
0 1 1 0 0 0 0 0 0 9 9 9 9 9 9 0 1 1 0 6 0 0 0 0
0 0 1 0 0 0 0 0 0 1 1 1 1 1 1 6 0 0 0 6 6 0 0 0
0 0 0 0 0 0 0 0 0 0 0 0 1 1 1 6 6 0 0 6 6 0 0 0
1 1 0 0 0 0 0 0 0 0 0 0 1 1 1 6 6 6 0 6 6 0 0 0
1 1 1 0 0 0 0 0 0 0 0 0 0 0 0 6 6 6 0 0 6 0 0 0
1 1 1 0 0 0 0 0 0 0 0 0 0 0 0 6 6 6 0 0 0 0 0 0
1 1 1 0 0 0 0 0 0 0 0 0 0 0 0 0 6 6 0 0 0 0 0 0
1 1 1 0 0 0 0 0 0 0 0 0 0 0 0 0 0 0 0 0 0 0 0 0
1 1 0 0 0 0 0 0 0 0 0 0 0 0 0 0 0 0 0 0 0 0 0 0
0 0 0 0 0 0 0 0 0 0 0 0 0 0 0 0 0 0 0 0 0 0 0 0
0 0 0 0 0 0 0 0 0 0 0 0 0 0 0 0 0 0 0 0 0 0 0 0
1 1 1 0 0 0 0 0 0 0 0 0 0 0 0 0 0 0 0 0 0 0 0 1
1 1 1 1 1 0 0 0 0 0 0 0 0 0 0 0 0 0 0 0 0 1 1 1
1 1 1 1 1 0 0 0 0 0 0 0 0 0 0 0 0 0 0 0 1 1 1 1

3
8 14 1 101
4 13 2 901
1 11 3 902
1

