40 40
0 0 0 0 6 0 0 6 6 6 6 6 0 0 0 0 0 0 0 6 6 0 1 0 0 0 0 1 1 0 0 0 6 6 6 6 6 6 6 6 
0 0 0 0 6 6 0 0 0 0 6 6 0 0 0 0 0 0 6 6 6 0 1 0 0 0 0 0 1 1 0 0 6 6 6 6 6 6 6 6 
0 0 0 0 0 6 0 6 6 0 6 6 6 0 0 0 6 6 6 6 6 0 1 1 1 0 0 0 0 0 0 0 6 6 6 6 6 6 6 6 
0 0 0 0 0 0 0 6 6 0 6 6 6 6 6 6 6 6 6 6 6 0 0 0 1 0 0 0 0 0 0 0 6 6 0 0 6 6 6 6 
0 0 0 0 0 0 0 6 6 0 0 0 6 6 6 6 6 6 6 6 6 6 6 0 1 0 0 0 0 0 0 0 0 0 0 6 6 6 6 6 
0 0 0 0 0 0 0 0 6 6 6 0 6 6 6 6 6 6 6 6 6 6 6 0 1 1 1 0 0 1 0 0 0 0 0 6 6 6 6 6 
6 0 0 0 0 0 0 0 6 6 6 0 6 6 6 6 6 6 6 6 6 6 6 0 0 0 1 0 0 1 1 1 1 0 0 6 6 6 6 6 
6 0 0 0 0 0 0 0 6 6 6 0 6 6 6 6 6 6 0 0 0 0 0 0 6 0 1 0 0 0 0 0 1 0 0 0 6 6 6 6 
6 6 0 0 0 0 0 0 6 6 6 0 0 6 6 0 0 0 0 6 6 6 0 0 6 0 1 0 0 6 6 0 1 0 0 0 6 6 6 6 
0 6 0 0 0 0 0 0 6 6 6 6 0 0 0 0 6 6 6 6 6 6 6 0 0 0 1 0 0 6 6 0 1 0 0 0 0 0 0 0 
0 6 0 0 0 0 0 0 0 6 6 6 6 6 6 6 6 6 6 6 6 6 6 6 0 0 1 1 0 6 6 0 1 1 0 0 0 0 0 0 
0 6 0 0 0 0 0 0 0 0 0 6 6 6 6 6 6 0 0 0 0 6 6 6 0 0 6 1 0 0 0 0 0 1 1 0 0 1 1 1 
0 6 0 0 0 0 0 0 0 0 0 6 6 6 6 6 0 0 0 0 0 0 0 0 0 6 6 1 1 0 0 0 0 0 1 1 1 1 0 0 
0 0 0 6 0 0 0 0 0 0 0 0 6 6 6 6 0 0 0 0 0 0 0 0 0 6 6 0 0 0 0 0 0 0 0 0 0 0 0 0 
6 6 0 6 6 6 6 0 0 0 0 0 0 0 0 0 0 0 0 0 0 0 0 0 0 6 6 0 0 0 0 0 0 0 0 0 0 0 0 0 
6 6 0 6 6 6 6 0 0 0 0 0 0 0 0 0 0 0 0 0 0 0 0 0 0 0 6 0 0 0 1 0 0 0 0 6 6 6 6 6 
6 6 0 0 0 0 6 0 0 0 0 0 0 0 0 0 0 0 0 0 0 0 0 0 0 0 6 6 0 0 1 1 1 0 0 6 6 6 6 6 
6 6 0 6 0 0 6 6 0 0 0 0 0 0 0 0 0 0 0 0 0 0 0 0 0 0 0 6 6 0 0 0 1 0 0 0 0 0 0 6 
0 0 0 6 6 0 0 6 6 0 0 0 0 0 0 6 6 6 6 6 6 6 0 0 0 0 0 0 6 0 0 0 1 0 0 0 0 0 0 6 
1 1 0 6 6 6 0 0 6 0 0 0 0 0 6 6 6 6 6 6 6 6 6 0 0 0 0 0 6 6 0 0 1 1 1 1 1 0 0 6 
0 1 0 6 6 6 6 0 6 6 0 0 0 6 6 0 0 0 0 0 6 6 6 6 0 0 0 0 0 6 6 6 0 0 0 0 1 0 0 0 
0 1 0 6 6 6 6 0 0 6 6 6 6 6 0 0 6 6 6 0 6 6 6 6 0 0 0 0 0 0 6 6 0 6 6 0 1 0 0 0 
0 1 0 6 6 6 6 6 0 6 6 6 6 6 0 6 6 6 6 0 0 6 6 6 6 0 0 0 0 0 0 6 0 6 6 0 1 1 1 0 
0 1 0 0 0 0 6 6 0 0 6 6 6 0 0 6 6 6 6 6 0 6 6 6 6 0 0 0 0 0 0 6 0 0 0 0 0 0 1 0 
0 1 1 1 1 0 6 6 6 0 0 0 0 0 0 0 0 0 6 6 0 6 6 6 0 0 0 0 0 0 0 6 6 6 0 6 6 0 1 1 
0 0 0 0 1 0 0 0 6 6 0 0 0 0 0 0 0 0 6 6 0 6 0 0 0 0 0 0 0 0 0 6 6 6 0 6 6 0 0 0 
0 0 0 0 1 1 1 0 6 6 0 0 0 1 0 0 0 0 6 6 0 6 0 0 0 0 0 0 0 0 6 6 6 6 0 0 6 6 6 6 
1 1 0 0 0 0 1 0 6 6 0 1 1 1 0 0 0 0 6 6 0 6 0 0 0 0 0 0 0 6 6 6 6 6 6 0 0 6 6 6 
0 1 0 0 0 0 1 0 0 0 0 1 0 0 0 0 0 0 0 6 0 6 0 0 0 0 0 0 0 6 6 6 6 6 6 6 0 6 6 6 
0 1 0 0 0 0 1 1 1 1 0 1 0 0 0 0 0 0 0 6 0 6 6 0 0 0 0 0 0 0 0 6 6 6 6 6 0 0 6 6 
0 1 1 0 0 0 0 0 0 1 1 1 0 0 0 0 0 1 0 6 0 0 6 6 0 0 0 0 0 0 0 6 6 6 6 6 6 0 0 6 
0 0 1 1 0 0 0 0 0 0 0 0 0 0 0 0 0 1 0 6 6 0 6 6 6 0 0 0 0 0 0 0 0 6 6 6 6 6 0 0 
0 0 0 0 0 0 0 0 0 0 0 0 0 0 0 0 0 1 0 6 6 0 0 6 6 6 0 0 0 0 0 0 0 0 0 6 6 6 6 6 
0 0 0 0 0 0 0 1 1 1 1 1 0 0 0 1 1 1 0 6 6 6 0 6 6 6 6 0 0 0 0 0 0 0 0 6 6 6 6 6 
6 6 6 0 0 1 1 1 0 0 0 1 0 0 0 1 0 0 0 6 6 6 0 0 6 6 6 6 0 0 0 0 0 0 0 0 0 6 6 6 
6 6 6 0 0 0 0 0 0 0 0 1 0 0 0 1 0 0 0 0 6 6 6 0 0 6 6 6 0 6 0 0 0 0 0 0 0 0 6 6 
6 6 6 0 0 0 0 0 0 0 0 1 1 0 0 1 1 1 1 0 6 6 6 0 0 0 0 0 0 6 6 0 0 0 0 0 0 0 0 0 
6 6 6 6 6 6 6 6 0 0 0 0 1 0 0 0 0 0 1 0 0 0 0 0 0 0 0 0 0 0 6 6 0 0 0 0 0 0 0 0 
6 6 6 6 6 6 6 6 6 0 0 0 1 1 1 1 1 0 1 1 1 1 1 1 0 0 0 0 6 0 0 6 6 0 0 0 0 0 0 0 
6 6 6 6 6 6 6 6 6 6 0 0 0 0 0 0 1 0 0 0 0 0 0 1 1 1 1 0 6 6 0 0 6 6 0 0 0 0 0 0 
0


1 
18 31 3 227



